####s###############
#000000000000#000#0#
#0########0#0#0#0#0#
#000#000000#0#0#0#0#
###0#0######0#0#0#0#
#000#0#0#0000#0#0#0#
#0###0#0#0####0#0#0#
#00#00#0#0000#0#0#0#
##0#0##0#0####0#0#0#
#00#0000#000000#0#0#
#0#######0######0#0#
#0000000#0000#000#0#
#######0#0####0###0#
#0000000#0000#00000#
################m###